0000000000000000
0111111011111111
0010011001111111
1111110011100000
0100000111001110
0111111100011110
0001111001110010
0111111111110110
0000000000000000