00000000000000000000000000000000
01111132111111100111113211111110
01112222111111100111222211111110
01111111111111100111111111111110
02221111111111100222111111111110
01111111111111100111111111111110
01111111111111100111111111111110
01111111111111100111111111111110
01111111111111111111111111111110
01111111111111111111111111111110
01111000011111111111113211111110
01112222011111111111222211111110
01111111000011100111111111111110
02221111011011100222111111111110
01111111110011100111111111111110
01111111111111100111111111111110
01111111111111111111111111111110
00000000000000000000000000000000